###############
#  E       E  #
# # # # # # # #
# # # # # # # #
# # # # # # # #
# # # ### # # #
# # #     # # #
#     # #     #
## ##     ## ##
#     # #     #
# # # ### # # #
# # # # # # # #
# # # # # # # #
#   P ###     #
###############